NO ./wall_xpm/wall1.xpm
SO ./wall_xpm/wall2.xpm

EA ./wall_xpm/wall3.xpm
WE ./wall_xpm/wall4.xpm

C 30,129,176
F 142,118,118


        1111111111111111111111111
        1000000000110000000000001
        1010000001110000E00100001
        1001000000000000001000001
111111111010000001110000000000011
100000000011000001110111111111111
11110111111111011100000010001
11110111111111011101010010001
11000000110101011100000010001
10000000000000001100000010001
10000000000000001101010010001
11000001110101011111011110011
11110111 1110101101111010001
111111111111111111111111111
