
NO ./wall_xpm/wall4.xpm
SO ./wall_xpm/wall4.xpm
EA ./wall_xpm/wall4.xpm
WE ./wall_xpm/wall4.xpm

C 82,53,173
F 142,118,118


     1   1   1   1   1   1   1   1   1   1   1   1   1   1   1   1   1   1   1 
    101 101 101 101 101 101 101 101 101 101 101 101 101 101 101 101 101 101 101
   10001000100010001000100010001000100010001000100010001000100010001000100010001
  1000000000000000000000000000000000000000000000000000000000000000000000000000001
 100111111111110011111111111001111111001111111111000111110001100001100011111100001
1001    11    101000000000110111011011001101111111111111110000000000011111111111101
1101  11  11  10100111110011111001111101111101100110011110000000000000000001 1000001
1001  11  11  10100100010010000001111011000011001100011001110011101110111001101111001
1101  11  11  1011111111111000000111110111100111111000110010100001000101010000010011
1001  11  11  101         101111011011011000111100111001110111111011101110010111011
1101  111111  10111111111110110111111100111110111111000110000100001000100010000011
1001  110011  1010010001001001011000110000011011001100011000111011101110001000001
1101  110011  101001110100111110110001101111111011001100111000000000000000000001
1001  110011  10100101010011011000110110110011011011111101010101010101010101001
110111110001111011100011111001111111000110000111000111110001100001100011111101
110000000000000E00000000000000000000000000000000000000000000000000000000000001
 11000000000000000000000000000000000000000000000000000000000000000000000000001
  1100000000001100110111100100010111011101000100100111001001001111000000000001
   110000000011001100000110110010100001001000101101010010100110000000000000011
    10000000110011000001100101010111001001010101101100011000011000000000000011
     1100001111110011111000100110100001001101101101010010100001111100000000011
      110000001100110000000100010111001000101000100100101001000000011000000011
       11000011000110000000000000000000000000000000000000000000000011000000001
        1100110000111111111111111111111111111111111111111111111111111000000011                 
         100000000000000000000000000000000000000000000000000000000000001000011
          11111111111111111111111111111111111111111111111111111111111110000001
           1111111111111111111111111111111111111111111111111111111111111111111




